r12
t,4
y,0
f24
g,1
h,3
d13
14d
6,2 6,2 6,2 6,2 6,2 6,2 6,2 6,2 6,2 6,2 6,2 6,2 6,2 6,2 6,2 6,2 1,4 1,4 1,4 1,4 1,4 1,4 1,4 6,2 6,2
1,4 1,4 1,4 1,4 1,4 1,4 1,4 1,4 1,4 1,4 1,4 1,4 1,4 1,4 6,2 6,2 1,4 1,4 1,4 1,4 1,4 1,4 6,2 6,2 1,4
1,4 1,4 1,4 1,4 1,4 6,2 6,2 6,2 6,2 6,2 6,2 6,2 1,4 1,4 6,2 1,4 1,4 1,4 6,2 6,2 6,2 6,2 6,2 1,4 1,4
1,4 1,4 6,2 6,2 6,2 6,2 1,4 1,4 1,4 1,4 1,4 6,2 1,4 6,2 6,2 6,2 6,2 6,2 6,2 1,4 1,4 1,4 1,4 1,4 1,4
1,4 1,4 6,2 1,4 1,4 1,4 1,4 1,4 1,4 1,4 1,4 6,2 6,2 6,2 1,4 1,4 1,4 1,4 1,4 1,4 1,4 1,4 1,4 1,4 1,4
1,4 1,4 6,2 1,4 1,4 1,4 1,4 1,4 1,4 1,4 1,4 1,4 6,2 1,4 1,4 1,4 1,4 1,4 1,4 1,4 1,4 1,4 1,4 1,4 1,4
1,4 1,4 6,2 1,4 1,4 1,4 1,4 1,4 1,4 1,4 1,4 1,4 6,2 6,2 6,2 6,2 6,2 6,2 1,4 1,4 1,4 1,4 1,4 1,4 1,4
1,4 1,4 6,2 1,4 1,4 1,4 1,4 1,4 1,4 1,4 1,4 1,4 6,2 1,4 1,4 1,4 1,4 6,2 6,2 6,2 6,2 6,2 6,2 6,2 6,2
1,4 1,4 6,2 1,4 1,4 1,4 1,4 1,4 1,4 1,4 1,4 1,4 6,2 6,2 6,2 1,4 1,4 1,4 1,4 1,4 1,4 1,4 1,4 1,4 1,4
1,4 6,2 6,2 6,2 6,2 6,2 6,2 6,2 6,2 6,2 6,2 1,4 6,2 1,4 6,2 6,2 6,2 6,2 6,2 6,2 1,4 1,4 1,4 1,4 1,4
1,4 6,2 6,2 1,4 1,4 6,2 1,4 1,4 1,4 1,4 6,2 6,2 6,2 1,4 1,4 1,4 1,4 1,4 6,2 6,2 6,2 1,4 1,4 1,4 1,4
1,4 1,4 6,2 1,4 1,4 6,2 1,4 1,4 1,4 1,4 1,4 1,4 6,2 1,4 1,4 1,4 1,4 1,4 6,2 6,2 6,2 6,2 1,4 1,4 1,4
1,4 6,2 6,2 1,4 1,4 6,2 1,4 1,4 1,4 1,4 1,4 1,4 6,2 1,4 1,4 1,4 1,4 1,4 1,4 6,2 1,4 6,2 6,2 6,2 1,4
6,2 6,2 1,4 1,4 1,4 6,2 6,2 1,4 1,4 1,4 1,4 1,4 6,2 1,4 1,4 1,4 1,4 1,4 1,4 6,2 1,4 1,4 1,4 6,2 6,2
1,4 1,4 1,4 1,4 1,4 1,4 6,2 1,4 1,4 1,4 1,4 1,4 6,2 6,2 1,4 1,4 1,4 1,4 1,4 6,2 6,2 1,4 1,4 1,4 1,4
z,1
s13
14s
d,1
0,d
5,0 5,1 5,0 5,0 5,0 5,0 5,0 5,0 5,0 5,0 5,1 5,0 5,0 5,0 5,0 5,0 5,0 5,0 5,0 5,0 5,0 5,0 5,1 5,0 5,0
5,0 5,1 5,0 5,0 5,0 5,0 5,0 5,0 5,0 5,0 5,1 5,0 5,0 5,0 5,0 5,0 5,0 5,0 5,0 5,1 5,1 5,1 5,1 5,0 5,0
5,0 5,1 5,0 5,0 5,0 5,0 5,0 5,0 5,0 5,0 5,1 5,1 5,0 5,0 5,0 5,0 5,0 5,1 5,1 5,1 5,0 5,0 5,1 5,0 5,0
5,0 5,1 5,0 5,0 5,1 5,1 5,1 5,1 5,1 5,1 5,1 5,1 5,1 5,0 5,0 5,0 5,1 5,1 5,0 5,0 5,0 5,0 5,1 5,0 5,0
5,0 5,1 5,0 5,0 5,0 5,0 5,0 5,0 5,1 5,1 5,0 5,0 5,1 5,1 5,1 5,1 5,1 5,0 5,0 5,0 5,0 5,0 5,1 5,0 5,0
5,0 5,1 5,0 5,0 5,0 5,0 5,0 5,1 5,1 5,0 5,0 5,0 5,0 5,1 5,1 5,0 5,0 5,0 5,0 5,0 5,0 5,0 5,1 5,0 5,0
5,0 5,1 5,0 5,0 5,0 5,0 5,1 5,1 5,0 5,0 5,0 5,0 5,0 5,0 5,1 5,0 5,0 5,0 5,0 5,0 5,0 5,0 5,1 5,0 5,0
5,0 5,1 5,0 5,0 5,1 5,1 5,1 5,0 5,0 5,0 5,0 5,0 5,0 5,0 5,1 5,1 5,0 5,0 5,0 5,1 5,1 5,1 5,1 5,0 5,0
5,0 5,1 5,1 5,1 5,1 5,0 5,0 5,0 5,0 5,0 5,0 5,0 5,0 5,0 5,1 5,1 5,0 5,0 5,0 5,0 5,0 5,0 5,1 5,0 5,0
5,0 5,0 5,0 5,1 5,1 5,1 5,1 5,1 5,1 5,1 5,1 5,1 5,1 5,1 5,1 5,1 5,1 5,1 5,0 5,0 5,0 5,0 5,1 5,0 5,0
5,0 5,0 5,0 5,0 5,0 5,0 5,0 5,1 5,1 5,1 5,1 5,1 5,1 5,1 5,1 5,1 5,1 5,1 5,0 5,0 5,0 5,0 5,1 5,1 5,1
5,0 5,0 5,0 5,0 5,0 5,0 5,1 5,1 5,0 5,0 5,1 5,0 5,0 5,0 5,0 5,0 5,0 5,1 5,1 5,0 5,0 5,0 5,0 5,0 5,1
5,1 5,1 5,1 5,1 5,1 5,1 5,1 5,0 5,0 5,0 5,1 5,0 5,0 5,0 5,0 5,0 5,0 5,0 5,1 5,0 5,0 5,0 5,0 5,0 5,0
5,0 5,0 5,0 5,0 5,0 5,1 5,0 5,0 5,0 5,0 5,1 5,0 5,0 5,0 5,0 5,0 5,0 5,0 5,1 5,1 5,1 5,0 5,0 5,0 5,0
5,0 5,0 5,0 5,0 5,1 5,1 5,0 5,0 5,0 5,0 5,1 5,1 5,1 5,1 5,0 5,0 5,0 5,0 5,0 5,0 5,1 5,1 5,1 5,1 5,1
z,1
s,1
0,s
d24
13d
0,0 0,5 0,0 0,0 0,0 0,0 0,0 0,0 0,5 0,5 0,5 0,5 0,5 0,0 0,0 0,0 0,0 0,0 0,0 0,0 0,0 0,0 0,0 0,0 0,0
0,0 0,5 0,0 0,0 0,0 0,0 0,5 0,5 0,5 0,0 0,0 0,0 0,5 0,5 0,5 0,5 0,5 0,5 0,5 0,5 0,5 0,5 0,0 0,0 0,0
0,0 0,5 0,0 0,0 0,0 0,5 0,5 0,0 0,0 0,0 0,0 0,0 0,0 0,0 0,0 0,0 0,0 0,0 0,5 0,5 0,5 0,5 0,0 0,0 0,0
0,0 0,5 0,0 0,0 0,5 0,5 0,0 0,0 0,0 0,0 0,0 0,0 0,0 0,0 0,0 0,0 0,5 0,5 0,5 0,0 0,0 0,0 0,0 0,0 0,0
0,0 0,5 0,0 0,0 0,5 0,0 0,0 0,0 0,0 0,0 0,0 0,0 0,0 0,0 0,0 0,0 0,5 0,0 0,0 0,0 0,5 0,5 0,5 0,5 0,0
0,0 0,5 0,0 0,0 0,5 0,0 0,0 0,0 0,0 0,5 0,5 0,5 0,0 0,0 0,0 0,0 0,5 0,0 0,0 0,5 0,5 0,0 0,0 0,5 0,5
0,0 0,5 0,5 0,5 0,5 0,5 0,5 0,5 0,5 0,5 0,0 0,5 0,5 0,0 0,0 0,0 0,5 0,0 0,0 0,5 0,0 0,0 0,0 0,0 0,0
0,0 0,0 0,0 0,0 0,5 0,0 0,0 0,0 0,0 0,0 0,0 0,0 0,5 0,0 0,0 0,0 0,5 0,0 0,0 0,5 0,0 0,0 0,0 0,0 0,0
0,0 0,0 0,0 0,0 0,5 0,0 0,0 0,0 0,0 0,0 0,0 0,0 0,5 0,5 0,0 0,0 0,0 0,0 0,0 0,5 0,0 0,0 0,0 0,0 0,0
0,0 0,0 0,0 0,0 0,5 0,0 0,0 0,0 0,0 0,0 0,0 0,0 0,0 0,5 0,0 0,0 0,0 0,0 0,0 0,5 0,5 0,0 0,0 0,0 0,0
0,0 0,0 0,0 0,5 0,5 0,5 0,0 0,0 0,0 0,0 0,0 0,0 0,0 0,5 0,0 0,0 0,0 0,0 0,0 0,5 0,5 0,5 0,5 0,0 0,0
0,0 0,0 0,5 0,5 0,0 0,5 0,5 0,5 0,5 0,5 0,0 0,0 0,0 0,5 0,0 0,0 0,0 0,0 0,5 0,5 0,0 0,0 0,5 0,0 0,0
0,0 0,0 0,5 0,0 0,0 0,0 0,0 0,0 0,0 0,5 0,0 0,0 0,0 0,5 0,0 0,0 0,0 0,5 0,5 0,0 0,0 0,0 0,5 0,5 0,0
0,0 0,5 0,5 0,0 0,0 0,0 0,0 0,0 0,0 0,5 0,5 0,5 0,5 0,5 0,5 0,5 0,5 0,5 0,0 0,0 0,0 0,0 0,0 0,5 0,5
0,5 0,5 0,0 0,0 0,0 0,0 0,0 0,0 0,0 0,0 0,0 0,0 0,0 0,0 0,0 0,0 0,0 0,0 0,0 0,0 0,0 0,0 0,0 0,0 0,0
z,1
s24
13s
d,2
14d
1,1 1,1 1,1 1,1 1,1 1,1 1,1 1,1 1,1 1,1 1,1 1,1 1,1 1,1 4,1 4,1 1,1 1,1 1,1 1,1 1,1 1,1 1,1 1,1 1,1
4,1 4,1 4,1 4,1 4,1 4,1 4,1 4,1 4,1 4,1 4,1 1,1 1,1 1,1 1,1 4,1 1,1 1,1 1,1 1,1 1,1 1,1 4,1 4,1 4,1
1,1 1,1 1,1 1,1 1,1 1,1 1,1 1,1 4,1 1,1 4,1 4,1 4,1 4,1 4,1 4,1 1,1 1,1 1,1 1,1 4,1 4,1 4,1 1,1 1,1
1,1 1,1 1,1 1,1 1,1 1,1 1,1 1,1 4,1 1,1 1,1 1,1 1,1 1,1 1,1 1,1 1,1 1,1 4,1 4,1 4,1 1,1 1,1 1,1 1,1
1,1 1,1 1,1 1,1 4,1 4,1 1,1 1,1 4,1 1,1 1,1 1,1 1,1 1,1 1,1 1,1 4,1 4,1 4,1 1,1 1,1 1,1 1,1 1,1 1,1
1,1 1,1 1,1 4,1 4,1 4,1 4,1 4,1 4,1 1,1 1,1 1,1 1,1 1,1 1,1 4,1 4,1 1,1 1,1 1,1 1,1 1,1 1,1 1,1 1,1
1,1 1,1 4,1 4,1 1,1 1,1 1,1 4,1 4,1 1,1 1,1 1,1 1,1 4,1 4,1 4,1 1,1 1,1 1,1 1,1 1,1 1,1 1,1 1,1 1,1
1,1 1,1 4,1 1,1 1,1 1,1 1,1 1,1 4,1 4,1 4,1 1,1 4,1 4,1 1,1 4,1 4,1 1,1 1,1 1,1 1,1 1,1 1,1 1,1 1,1
4,1 4,1 4,1 1,1 1,1 1,1 1,1 1,1 1,1 1,1 4,1 4,1 4,1 1,1 1,1 1,1 4,1 4,1 1,1 1,1 1,1 1,1 1,1 1,1 1,1
4,1 1,1 1,1 1,1 1,1 1,1 1,1 1,1 1,1 1,1 1,1 4,1 1,1 1,1 1,1 1,1 1,1 4,1 4,1 4,1 1,1 1,1 1,1 1,1 1,1
1,1 1,1 1,1 1,1 1,1 1,1 1,1 1,1 1,1 1,1 1,1 4,1 4,1 1,1 1,1 1,1 1,1 1,1 1,1 4,1 4,1 4,1 1,1 1,1 1,1
1,1 1,1 1,1 1,1 1,1 1,1 1,1 1,1 1,1 1,1 1,1 1,1 4,1 1,1 1,1 1,1 1,1 1,1 1,1 1,1 1,1 4,1 4,1 1,1 1,1
1,1 1,1 1,1 1,1 1,1 1,1 1,1 1,1 1,1 1,1 1,1 1,1 4,1 4,1 4,1 1,1 1,1 1,1 1,1 1,1 1,1 1,1 4,1 1,1 1,1
1,1 1,1 1,1 1,1 1,1 1,1 1,1 4,1 4,1 4,1 4,1 4,1 4,1 1,1 4,1 4,1 4,1 4,1 4,1 4,1 4,1 4,1 4,1 4,1 4,1
1,1 1,1 4,1 4,1 4,1 4,1 4,1 4,1 1,1 1,1 1,1 1,1 1,1 1,1 1,1 1,1 1,1 1,1 1,1 1,1 1,1 1,1 1,1 1,1 1,1
z,1
s,2
14s
2,0 2,0 2,0 2,0 3,4 3,4 3,4 2,0 2,0 2,0 2,0 2,0 2,0 2,0 2,0 2,0 2,0 2,0 2,0 2,0 2,0 2,0 3,4 3,4 2,0
2,0 2,0 2,0 2,0 2,0 2,0 3,4 3,4 3,4 2,0 2,0 2,0 2,0 2,0 2,0 2,0 2,0 2,0 2,0 3,4 3,4 3,4 3,4 2,0 2,0
2,0 2,0 2,0 2,0 2,0 2,0 2,0 2,0 3,4 3,4 2,0 2,0 2,0 2,0 3,4 3,4 3,4 3,4 3,4 3,4 2,0 2,0 2,0 2,0 2,0
2,0 2,0 2,0 2,0 2,0 2,0 2,0 2,0 2,0 3,4 3,4 2,0 3,4 3,4 3,4 2,0 2,0 2,0 2,0 2,0 2,0 2,0 2,0 2,0 2,0
3,4 3,4 3,4 2,0 2,0 2,0 2,0 2,0 2,0 2,0 3,4 3,4 3,4 2,0 2,0 2,0 2,0 2,0 2,0 2,0 2,0 2,0 2,0 2,0 2,0
2,0 2,0 3,4 3,4 3,4 2,0 2,0 2,0 2,0 2,0 3,4 3,4 3,4 2,0 2,0 2,0 2,0 2,0 3,4 3,4 3,4 3,4 3,4 3,4 3,4
2,0 2,0 2,0 2,0 3,4 3,4 3,4 2,0 2,0 2,0 2,0 2,0 3,4 3,4 2,0 2,0 3,4 3,4 3,4 2,0 2,0 2,0 2,0 2,0 2,0
2,0 2,0 2,0 2,0 2,0 2,0 3,4 3,4 2,0 2,0 2,0 2,0 2,0 3,4 3,4 3,4 3,4 2,0 2,0 2,0 2,0 2,0 2,0 2,0 2,0
2,0 2,0 2,0 2,0 2,0 2,0 2,0 3,4 2,0 2,0 3,4 3,4 3,4 3,4 2,0 2,0 2,0 2,0 2,0 2,0 2,0 2,0 2,0 2,0 2,0
2,0 2,0 2,0 2,0 2,0 2,0 2,0 3,4 3,4 3,4 3,4 2,0 2,0 2,0 2,0 2,0 2,0 2,0 2,0 2,0 2,0 2,0 2,0 2,0 2,0
2,0 2,0 2,0 2,0 2,0 2,0 2,0 2,0 2,0 3,4 3,4 2,0 2,0 2,0 2,0 2,0 2,0 2,0 2,0 3,4 3,4 3,4 3,4 2,0 2,0
2,0 2,0 2,0 2,0 2,0 2,0 2,0 2,0 2,0 2,0 3,4 3,4 3,4 3,4 3,4 3,4 3,4 3,4 3,4 3,4 2,0 2,0 3,4 3,4 2,0
2,0 2,0 2,0 2,0 2,0 2,0 2,0 2,0 2,0 3,4 3,4 3,4 2,0 2,0 2,0 2,0 2,0 2,0 2,0 2,0 2,0 2,0 2,0 3,4 2,0
2,0 2,0 2,0 2,0 2,0 2,0 3,4 3,4 3,4 3,4 2,0 2,0 2,0 2,0 2,0 2,0 2,0 2,0 2,0 2,0 2,0 2,0 2,0 3,4 3,4
2,0 2,0 3,4 3,4 3,4 3,4 3,4 2,0 2,0 2,0 2,0 2,0 2,0 2,0 2,0 2,0 2,0 2,0 2,0 2,0 2,0 2,0 2,0 2,0 3,4