r17
t14
y,2
f,1
g,0
h,4
d10
14d
5,0 5,1 5,0 5,0 5,0 5,0 5,0 5,0 5,0 5,1 5,1 5,1 5,0 5,0 5,0 5,0 5,0 5,1 5,1 5,0 5,0 5,0 5,0 5,0 5,0
5,0 5,1 5,1 5,0 5,0 5,0 5,0 5,0 5,0 5,0 5,0 5,1 5,1 5,1 5,0 5,0 5,1 5,1 5,0 5,0 5,0 5,0 5,1 5,1 5,1
5,0 5,0 5,1 5,1 5,0 5,0 5,0 5,0 5,0 5,0 5,0 5,0 5,0 5,1 5,1 5,1 5,1 5,0 5,0 5,0 5,0 5,0 5,1 5,0 5,0
5,0 5,0 5,0 5,1 5,1 5,1 5,0 5,0 5,0 5,0 5,0 5,0 5,0 5,1 5,1 5,1 5,0 5,0 5,0 5,0 5,0 5,1 5,1 5,0 5,0
5,0 5,0 5,0 5,0 5,1 5,1 5,1 5,0 5,1 5,1 5,1 5,1 5,1 5,1 5,0 5,0 5,0 5,0 5,0 5,1 5,1 5,1 5,0 5,0 5,0
5,0 5,0 5,0 5,1 5,1 5,0 5,1 5,1 5,1 5,0 5,0 5,0 5,0 5,0 5,0 5,0 5,1 5,1 5,1 5,1 5,0 5,0 5,0 5,0 5,0
5,0 5,0 5,1 5,1 5,0 5,0 5,0 5,1 5,0 5,0 5,0 5,0 5,0 5,1 5,1 5,1 5,1 5,0 5,0 5,0 5,0 5,0 5,0 5,0 5,1
5,0 5,0 5,1 5,0 5,0 5,0 5,0 5,1 5,1 5,0 5,0 5,1 5,1 5,1 5,0 5,0 5,0 5,0 5,0 5,0 5,0 5,0 5,0 5,1 5,1
5,0 5,1 5,1 5,0 5,0 5,0 5,0 5,0 5,1 5,1 5,1 5,1 5,0 5,0 5,0 5,0 5,0 5,0 5,0 5,0 5,0 5,1 5,1 5,1 5,0
5,0 5,1 5,0 5,0 5,0 5,0 5,0 5,0 5,0 5,1 5,1 5,1 5,0 5,0 5,0 5,0 5,0 5,1 5,1 5,1 5,1 5,1 5,0 5,0 5,0
5,0 5,1 5,0 5,0 5,0 5,0 5,1 5,1 5,1 5,1 5,0 5,1 5,1 5,0 5,0 5,0 5,1 5,1 5,0 5,0 5,0 5,0 5,0 5,0 5,0
5,0 5,1 5,1 5,0 5,0 5,1 5,1 5,0 5,0 5,0 5,0 5,0 5,1 5,1 5,1 5,1 5,1 5,1 5,1 5,0 5,0 5,0 5,0 5,0 5,0
5,0 5,0 5,1 5,1 5,1 5,1 5,0 5,0 5,0 5,0 5,0 5,0 5,0 5,1 5,1 5,0 5,0 5,0 5,1 5,1 5,0 5,0 5,0 5,0 5,0
5,0 5,0 5,1 5,0 5,0 5,0 5,0 5,0 5,0 5,0 5,0 5,1 5,1 5,1 5,0 5,0 5,0 5,0 5,0 5,1 5,1 5,1 5,0 5,0 5,0
5,1 5,1 5,1 5,0 5,0 5,0 5,0 5,0 5,0 5,0 5,1 5,1 5,0 5,0 5,0 5,0 5,0 5,0 5,0 5,0 5,0 5,1 5,1 5,0 5,0
z,1
s10
14s
d,1
12d
5,0 5,0 5,0 5,0 5,0 5,0 5,0 5,0 5,0 5,0 5,0 5,0 5,0 5,0 5,0 5,0 5,0 5,0 5,1 5,1 5,0 5,0 5,0 5,0 5,0
5,0 5,0 5,0 5,0 5,0 5,0 5,0 5,0 5,0 5,0 5,0 5,0 5,0 5,0 5,0 5,0 5,0 5,1 5,1 5,0 5,0 5,0 5,0 5,0 5,1
5,0 5,0 5,1 5,1 5,0 5,0 5,0 5,0 5,0 5,0 5,0 5,0 5,1 5,1 5,1 5,1 5,1 5,1 5,0 5,0 5,0 5,0 5,0 5,1 5,1
5,0 5,0 5,0 5,1 5,1 5,0 5,0 5,0 5,0 5,1 5,1 5,1 5,1 5,0 5,0 5,0 5,1 5,1 5,0 5,0 5,0 5,1 5,1 5,1 5,0
5,0 5,0 5,0 5,0 5,1 5,1 5,1 5,0 5,1 5,1 5,0 5,0 5,0 5,0 5,0 5,0 5,0 5,1 5,1 5,0 5,1 5,1 5,0 5,0 5,0
5,0 5,0 5,0 5,0 5,0 5,0 5,1 5,1 5,1 5,0 5,0 5,0 5,0 5,0 5,0 5,0 5,0 5,0 5,1 5,1 5,1 5,0 5,0 5,0 5,0
5,0 5,0 5,0 5,0 5,0 5,0 5,0 5,1 5,0 5,0 5,0 5,0 5,0 5,0 5,0 5,0 5,1 5,1 5,1 5,1 5,0 5,0 5,0 5,0 5,0
5,0 5,0 5,0 5,0 5,0 5,0 5,0 5,1 5,0 5,0 5,0 5,0 5,0 5,0 5,1 5,1 5,1 5,0 5,0 5,1 5,1 5,1 5,1 5,1 5,1
5,0 5,0 5,0 5,1 5,1 5,1 5,1 5,1 5,1 5,0 5,0 5,0 5,1 5,1 5,1 5,0 5,0 5,0 5,0 5,1 5,1 5,0 5,0 5,0 5,0
5,0 5,0 5,1 5,1 5,0 5,0 5,0 5,0 5,1 5,0 5,1 5,1 5,1 5,0 5,0 5,0 5,0 5,0 5,0 5,0 5,1 5,1 5,0 5,0 5,0
5,0 5,0 5,0 5,0 5,0 5,0 5,0 5,0 5,1 5,1 5,1 5,0 5,0 5,0 5,0 5,0 5,0 5,0 5,0 5,0 5,1 5,1 5,1 5,1 5,0
5,0 5,0 5,0 5,0 5,0 5,0 5,0 5,0 5,1 5,1 5,0 5,0 5,0 5,0 5,0 5,0 5,0 5,0 5,0 5,1 5,1 5,0 5,0 5,1 5,1
5,0 5,1 5,1 5,1 5,1 5,1 5,1 5,1 5,1 5,0 5,0 5,0 5,0 5,0 5,0 5,0 5,0 5,0 5,0 5,1 5,0 5,0 5,0 5,0 5,0
5,0 5,0 5,0 5,0 5,0 5,0 5,0 5,1 5,1 5,0 5,0 5,0 5,0 5,0 5,0 5,0 5,0 5,0 5,1 5,1 5,0 5,0 5,0 5,0 5,0
5,0 5,0 5,0 5,0 5,0 5,0 5,0 5,0 5,1 5,1 5,1 5,0 5,0 5,0 5,0 5,0 5,0 5,1 5,1 5,0 5,0 5,0 5,0 5,0 5,0
z,1
s,1
12s
d21
1,d
5,1 5,1 5,0 5,0 5,0 5,0 5,0 5,0 5,0 5,0 5,0 5,0 5,1 5,1 5,0 5,0 5,0 5,0 5,0 5,0 5,0 5,0 5,0 5,0 5,0
5,1 5,0 5,0 5,0 5,0 5,0 5,0 5,1 5,1 5,1 5,1 5,1 5,1 5,0 5,0 5,0 5,0 5,0 5,0 5,0 5,0 5,1 5,0 5,0 5,0
5,1 5,0 5,0 5,1 5,1 5,1 5,1 5,1 5,0 5,0 5,0 5,0 5,0 5,0 5,0 5,0 5,0 5,1 5,1 5,1 5,1 5,1 5,0 5,0 5,0
5,1 5,0 5,0 5,0 5,1 5,1 5,0 5,0 5,0 5,0 5,0 5,0 5,0 5,0 5,0 5,1 5,1 5,1 5,0 5,0 5,0 5,0 5,0 5,0 5,0
5,1 5,0 5,0 5,0 5,1 5,1 5,1 5,0 5,0 5,0 5,0 5,0 5,0 5,0 5,1 5,1 5,0 5,0 5,0 5,0 5,0 5,0 5,0 5,0 5,0
5,1 5,0 5,1 5,1 5,1 5,0 5,1 5,1 5,0 5,0 5,0 5,1 5,1 5,1 5,1 5,1 5,1 5,1 5,0 5,0 5,0 5,0 5,0 5,0 5,1
5,1 5,1 5,1 5,0 5,0 5,0 5,0 5,1 5,1 5,1 5,1 5,1 5,0 5,0 5,0 5,0 5,0 5,1 5,1 5,0 5,0 5,0 5,0 5,0 5,1
5,0 5,0 5,0 5,0 5,0 5,0 5,0 5,0 5,1 5,1 5,1 5,0 5,0 5,0 5,0 5,0 5,0 5,0 5,1 5,1 5,0 5,0 5,1 5,1 5,1
5,0 5,0 5,0 5,0 5,0 5,0 5,1 5,1 5,1 5,0 5,1 5,1 5,0 5,0 5,0 5,0 5,0 5,0 5,0 5,1 5,0 5,0 5,1 5,0 5,0
5,0 5,0 5,0 5,0 5,0 5,1 5,1 5,0 5,0 5,0 5,0 5,1 5,1 5,0 5,0 5,0 5,0 5,0 5,0 5,1 5,1 5,1 5,1 5,0 5,0
5,0 5,0 5,0 5,1 5,1 5,1 5,0 5,0 5,0 5,0 5,0 5,1 5,1 5,1 5,1 5,0 5,0 5,0 5,0 5,0 5,0 5,1 5,1 5,0 5,0
5,0 5,0 5,1 5,1 5,0 5,0 5,0 5,0 5,0 5,0 5,1 5,1 5,0 5,0 5,1 5,1 5,0 5,0 5,0 5,0 5,0 5,1 5,0 5,0 5,0
5,0 5,1 5,1 5,0 5,0 5,0 5,0 5,0 5,0 5,1 5,1 5,0 5,0 5,0 5,0 5,1 5,0 5,0 5,0 5,0 5,0 5,1 5,0 5,0 5,0
5,0 5,0 5,0 5,0 5,0 5,0 5,0 5,0 5,1 5,1 5,0 5,0 5,0 5,0 5,0 5,1 5,1 5,0 5,0 5,0 5,0 5,1 5,0 5,0 5,0
5,0 5,0 5,0 5,0 5,1 5,1 5,1 5,1 5,1 5,0 5,0 5,0 5,0 5,0 5,0 5,0 5,1 5,1 5,0 5,0 5,0 5,1 5,1 5,1 5,1
z,1
s21
1,s
d23
14d
5,1 5,1 5,0 5,0 5,0 5,0 5,0 5,0 5,0 5,0 5,0 5,0 5,0 5,0 5,0 5,0 5,0 5,0 5,0 5,0 5,1 5,1 5,1 5,0 5,0
5,1 5,1 5,1 5,0 5,0 5,0 5,0 5,0 5,0 5,0 5,0 5,0 5,0 5,0 5,0 5,0 5,0 5,0 5,0 5,0 5,1 5,1 5,1 5,0 5,0
5,1 5,1 5,1 5,0 5,1 5,1 5,1 5,1 5,1 5,1 5,1 5,1 5,0 5,0 5,0 5,0 5,0 5,0 5,1 5,1 5,1 5,1 5,1 5,1 5,0
5,1 5,1 5,1 5,1 5,1 5,1 5,1 5,0 5,0 5,0 5,0 5,1 5,1 5,1 5,1 5,0 5,0 5,1 5,1 5,0 5,0 5,0 5,0 5,1 5,1
5,0 5,0 5,0 5,0 5,0 5,0 5,1 5,1 5,0 5,0 5,0 5,0 5,0 5,0 5,1 5,1 5,1 5,0 5,0 5,0 5,0 5,0 5,0 5,0 5,0
5,0 5,0 5,0 5,0 5,0 5,0 5,1 5,1 5,1 5,0 5,0 5,0 5,0 5,0 5,0 5,0 5,0 5,0 5,0 5,0 5,0 5,0 5,0 5,0 5,0
5,1 5,1 5,1 5,1 5,1 5,1 5,1 5,1 5,1 5,1 5,0 5,0 5,0 5,0 5,0 5,0 5,0 5,0 5,1 5,1 5,1 5,0 5,1 5,1 5,1
5,0 5,0 5,0 5,0 5,0 5,0 5,0 5,1 5,1 5,1 5,1 5,1 5,1 5,1 5,0 5,0 5,0 5,1 5,1 5,0 5,1 5,1 5,1 5,0 5,0
5,0 5,0 5,0 5,0 5,0 5,0 5,1 5,1 5,0 5,1 5,1 5,0 5,0 5,0 5,0 5,0 5,1 5,1 5,0 5,0 5,0 5,1 5,0 5,0 5,0
5,0 5,0 5,0 5,0 5,1 5,1 5,1 5,0 5,0 5,0 5,1 5,0 5,0 5,0 5,0 5,1 5,1 5,0 5,0 5,0 5,0 5,1 5,0 5,0 5,0
5,0 5,0 5,0 5,1 5,1 5,0 5,0 5,0 5,0 5,0 5,1 5,1 5,0 5,1 5,1 5,1 5,0 5,0 5,0 5,0 5,0 5,1 5,0 5,0 5,0
5,0 5,1 5,1 5,1 5,0 5,0 5,0 5,0 5,0 5,0 5,1 5,1 5,1 5,1 5,1 5,0 5,0 5,0 5,0 5,0 5,0 5,1 5,1 5,0 5,0
5,1 5,1 5,0 5,0 5,0 5,0 5,0 5,0 5,0 5,1 5,1 5,0 5,0 5,0 5,1 5,1 5,0 5,0 5,0 5,0 5,0 5,0 5,1 5,0 5,0
5,0 5,0 5,0 5,0 5,0 5,0 5,0 5,0 5,0 5,1 5,0 5,0 5,0 5,0 5,0 5,1 5,0 5,0 5,0 5,0 5,0 5,0 5,1 5,0 5,0
5,0 5,0 5,0 5,0 5,0 5,0 5,0 5,0 5,1 5,1 5,0 5,0 5,0 5,0 5,0 5,1 5,1 5,0 5,0 5,0 5,0 5,0 5,1 5,1 5,0
z,1
s23
14s
d23
14d
5,0 5,1 5,0 5,0 5,0 5,0 5,0 5,0 5,0 5,1 5,0 5,0 5,0 5,0 5,0 5,0 5,1 5,1 5,1 5,0 5,0 5,0 5,0 5,0 5,1
5,1 5,1 5,0 5,0 5,0 5,0 5,0 5,0 5,0 5,1 5,0 5,0 5,0 5,1 5,1 5,1 5,1 5,0 5,0 5,0 5,0 5,0 5,0 5,1 5,0
5,1 5,0 5,0 5,0 5,0 5,0 5,0 5,0 5,0 5,1 5,0 5,0 5,1 5,1 5,0 5,0 5,0 5,0 5,0 5,0 5,0 5,0 5,1 5,1 5,0
5,1 5,0 5,0 5,0 5,0 5,1 5,0 5,0 5,0 5,1 5,1 5,1 5,1 5,0 5,0 5,0 5,0 5,0 5,0 5,0 5,0 5,1 5,1 5,0 5,0
5,1 5,1 5,0 5,0 5,0 5,1 5,0 5,0 5,0 5,0 5,1 5,1 5,0 5,0 5,0 5,0 5,0 5,0 5,0 5,0 5,1 5,1 5,0 5,0 5,0
5,0 5,1 5,0 5,0 5,0 5,1 5,0 5,0 5,0 5,0 5,0 5,1 5,1 5,0 5,0 5,0 5,0 5,0 5,1 5,1 5,1 5,0 5,0 5,0 5,0
5,0 5,1 5,1 5,1 5,1 5,1 5,0 5,0 5,0 5,0 5,0 5,0 5,1 5,1 5,0 5,0 5,0 5,0 5,1 5,0 5,0 5,0 5,0 5,0 5,0
5,0 5,0 5,0 5,1 5,0 5,1 5,1 5,0 5,0 5,0 5,0 5,0 5,0 5,1 5,1 5,1 5,0 5,1 5,1 5,0 5,0 5,0 5,0 5,0 5,0
5,0 5,0 5,0 5,1 5,0 5,0 5,1 5,1 5,0 5,0 5,0 5,0 5,0 5,0 5,0 5,1 5,1 5,1 5,1 5,1 5,0 5,0 5,0 5,0 5,0
5,0 5,0 5,1 5,1 5,0 5,0 5,0 5,1 5,1 5,0 5,0 5,0 5,0 5,0 5,0 5,0 5,1 5,1 5,0 5,1 5,0 5,0 5,0 5,0 5,0
5,0 5,0 5,1 5,0 5,0 5,0 5,0 5,0 5,1 5,1 5,1 5,0 5,0 5,0 5,0 5,1 5,1 5,0 5,0 5,1 5,1 5,0 5,0 5,0 5,0
5,0 5,0 5,1 5,1 5,0 5,0 5,0 5,0 5,0 5,0 5,1 5,1 5,1 5,0 5,0 5,1 5,0 5,0 5,0 5,0 5,1 5,0 5,0 5,0 5,0
5,0 5,0 5,0 5,1 5,1 5,1 5,1 5,1 5,1 5,1 5,1 5,0 5,1 5,1 5,1 5,1 5,0 5,0 5,0 5,0 5,1 5,1 5,0 5,0 5,0
5,0 5,1 5,1 5,1 5,0 5,0 5,0 5,0 5,0 5,0 5,0 5,0 5,0 5,0 5,1 5,0 5,0 5,0 5,0 5,0 5,0 5,1 5,1 5,0 5,0
5,1 5,1 5,0 5,0 5,0 5,0 5,0 5,0 5,0 5,0 5,0 5,0 5,0 5,0 5,1 5,1 5,1 5,0 5,0 5,0 5,0 5,0 5,1 5,1 5,0