r,2
t,1
y,4
f,4
g14
h,2
s,0
14s
0,4 0,4 0,4 6,2 6,2 0,4 0,4 0,4 6,2 0,4 0,4 6,2 0,4 0,4 0,4 0,4 0,4 6,2 6,2 0,4 0,4 0,4 0,4 6,2 6,2
0,4 0,4 6,2 0,4 0,4 0,4 0,4 0,4 6,2 0,4 0,4 6,2 0,4 0,4 0,4 6,2 6,2 6,2 0,4 0,4 0,4 0,4 6,2 6,2 0,4
0,4 0,4 6,2 0,4 0,4 0,4 0,4 0,4 6,2 0,4 0,4 6,2 0,4 6,2 6,2 6,2 0,4 0,4 0,4 0,4 6,2 6,2 0,4 0,4 0,4
0,4 0,4 6,2 0,4 0,4 0,4 0,4 0,4 6,2 0,4 0,4 6,2 6,2 6,2 0,4 0,4 0,4 0,4 6,2 6,2 6,2 0,4 0,4 0,4 0,4
0,4 6,2 6,2 0,4 0,4 0,4 0,4 0,4 6,2 0,4 0,4 0,4 6,2 0,4 6,2 6,2 6,2 6,2 6,2 6,2 0,4 0,4 0,4 0,4 0,4
0,4 6,2 0,4 0,4 0,4 0,4 0,4 0,4 6,2 0,4 0,4 0,4 6,2 6,2 6,2 0,4 0,4 0,4 0,4 6,2 6,2 0,4 0,4 0,4 0,4
0,4 6,2 0,4 0,4 0,4 0,4 0,4 0,4 6,2 6,2 0,4 6,2 6,2 6,2 0,4 0,4 0,4 0,4 0,4 0,4 6,2 6,2 0,4 0,4 0,4
6,2 6,2 6,2 0,4 0,4 0,4 0,4 0,4 0,4 6,2 6,2 6,2 6,2 6,2 6,2 6,2 6,2 0,4 0,4 0,4 0,4 0,4 0,4 0,4 0,4
6,2 0,4 6,2 6,2 0,4 0,4 0,4 0,4 6,2 6,2 6,2 0,4 0,4 0,4 0,4 0,4 6,2 6,2 6,2 0,4 0,4 0,4 0,4 0,4 6,2
6,2 0,4 0,4 6,2 6,2 6,2 0,4 6,2 6,2 0,4 0,4 0,4 0,4 0,4 0,4 0,4 0,4 0,4 6,2 6,2 6,2 6,2 6,2 6,2 6,2
6,2 0,4 0,4 0,4 0,4 6,2 6,2 6,2 0,4 0,4 0,4 0,4 0,4 0,4 0,4 0,4 0,4 0,4 6,2 6,2 6,2 0,4 0,4 0,4 0,4
6,2 0,4 0,4 0,4 0,4 0,4 0,4 6,2 6,2 0,4 0,4 0,4 0,4 0,4 0,4 0,4 0,4 0,4 0,4 6,2 6,2 0,4 0,4 0,4 0,4
6,2 0,4 0,4 0,4 0,4 0,4 0,4 0,4 6,2 6,2 0,4 0,4 0,4 0,4 0,4 0,4 0,4 0,4 6,2 6,2 6,2 6,2 0,4 0,4 0,4
6,2 0,4 0,4 0,4 0,4 0,4 0,4 0,4 0,4 6,2 6,2 0,4 0,4 0,4 0,4 0,4 0,4 6,2 6,2 0,4 0,4 6,2 6,2 0,4 0,4
6,2 6,2 6,2 6,2 6,2 6,2 0,4 0,4 0,4 0,4 6,2 6,2 6,2 6,2 6,2 0,4 0,4 6,2 0,4 0,4 0,4 0,4 6,2 6,2 6,2
z,1
s,8
0,s
d,0
14d
0,4 0,4 0,4 0,4 0,4 0,4 0,4 6,2 6,2 6,2 6,2 6,2 6,2 6,2 6,2 6,2 6,2 6,2 6,2 6,2 6,2 6,2 6,2 6,2 6,2
0,4 0,4 0,4 0,4 0,4 0,4 6,2 6,2 0,4 0,4 0,4 0,4 0,4 0,4 6,2 6,2 6,2 6,2 0,4 0,4 0,4 0,4 0,4 0,4 6,2
0,4 0,4 0,4 0,4 0,4 6,2 6,2 6,2 0,4 0,4 6,2 6,2 6,2 6,2 6,2 0,4 0,4 0,4 0,4 0,4 0,4 0,4 0,4 0,4 6,2
0,4 0,4 0,4 0,4 6,2 6,2 0,4 6,2 6,2 6,2 6,2 0,4 0,4 0,4 0,4 0,4 0,4 0,4 6,2 6,2 6,2 6,2 6,2 6,2 6,2
0,4 0,4 0,4 0,4 6,2 0,4 0,4 0,4 6,2 0,4 0,4 0,4 0,4 0,4 6,2 6,2 6,2 6,2 6,2 0,4 0,4 0,4 0,4 0,4 0,4
0,4 0,4 0,4 6,2 6,2 0,4 0,4 0,4 6,2 6,2 6,2 6,2 6,2 6,2 6,2 0,4 0,4 0,4 0,4 0,4 0,4 0,4 0,4 0,4 0,4
0,4 6,2 6,2 6,2 0,4 0,4 0,4 0,4 0,4 6,2 0,4 0,4 0,4 6,2 6,2 0,4 0,4 0,4 0,4 0,4 0,4 0,4 0,4 0,4 0,4
6,2 6,2 0,4 6,2 0,4 0,4 0,4 0,4 0,4 6,2 0,4 0,4 0,4 0,4 6,2 0,4 0,4 0,4 0,4 0,4 0,4 0,4 0,4 0,4 6,2
0,4 0,4 0,4 6,2 0,4 0,4 0,4 0,4 0,4 6,2 0,4 0,4 0,4 0,4 0,4 6,2 0,4 0,4 0,4 0,4 0,4 0,4 6,2 6,2 6,2
0,4 0,4 0,4 6,2 6,2 0,4 0,4 0,4 0,4 6,2 0,4 0,4 0,4 0,4 0,4 6,2 6,2 0,4 0,4 0,4 0,4 6,2 6,2 0,4 0,4
0,4 0,4 0,4 0,4 6,2 0,4 0,4 0,4 0,4 6,2 6,2 0,4 0,4 0,4 0,4 0,4 6,2 6,2 0,4 0,4 6,2 6,2 0,4 0,4 0,4
0,4 0,4 0,4 0,4 6,2 0,4 0,4 0,4 0,4 6,2 6,2 6,2 0,4 0,4 0,4 0,4 0,4 6,2 0,4 6,2 6,2 0,4 0,4 0,4 0,4
0,4 0,4 0,4 0,4 6,2 0,4 0,4 0,4 6,2 6,2 0,4 6,2 6,2 0,4 0,4 0,4 0,4 6,2 6,2 6,2 0,4 0,4 0,4 0,4 0,4
0,4 0,4 0,4 0,4 6,2 0,4 0,4 6,2 6,2 0,4 0,4 0,4 6,2 0,4 0,4 0,4 0,4 0,4 6,2 0,4 0,4 0,4 0,4 6,2 6,2
6,2 6,2 6,2 6,2 6,2 0,4 0,4 6,2 0,4 0,4 0,4 0,4 6,2 6,2 6,2 6,2 6,2 6,2 6,2 6,2 6,2 6,2 6,2 6,2 0,4
z,1
s12
0,s
d,8
0,d
0,4 0,4 0,4 0,4 0,4 0,4 0,4 6,2 6,2 0,4 0,4 0,4 6,2 0,4 0,4 0,4 0,4 0,4 0,4 0,4 0,4 0,4 0,4 0,4 0,4
0,4 0,4 0,4 0,4 0,4 6,2 6,2 6,2 0,4 0,4 0,4 0,4 6,2 0,4 0,4 0,4 0,4 0,4 0,4 0,4 0,4 0,4 0,4 0,4 6,2
6,2 6,2 0,4 0,4 6,2 6,2 0,4 0,4 0,4 0,4 0,4 0,4 6,2 6,2 0,4 0,4 0,4 0,4 0,4 0,4 0,4 0,4 0,4 0,4 6,2
0,4 6,2 6,2 0,4 6,2 0,4 0,4 0,4 0,4 0,4 0,4 0,4 0,4 6,2 6,2 0,4 0,4 0,4 0,4 0,4 0,4 0,4 6,2 6,2 6,2
0,4 0,4 6,2 6,2 6,2 0,4 0,4 0,4 0,4 0,4 0,4 0,4 0,4 6,2 6,2 6,2 6,2 0,4 0,4 0,4 0,4 6,2 6,2 0,4 0,4
0,4 0,4 0,4 0,4 6,2 0,4 0,4 0,4 0,4 0,4 6,2 6,2 6,2 6,2 0,4 0,4 6,2 6,2 0,4 0,4 6,2 6,2 0,4 0,4 0,4
0,4 0,4 0,4 0,4 6,2 6,2 0,4 0,4 6,2 6,2 6,2 0,4 0,4 0,4 0,4 0,4 0,4 6,2 6,2 6,2 6,2 0,4 0,4 0,4 0,4
0,4 0,4 0,4 0,4 0,4 6,2 6,2 6,2 6,2 0,4 0,4 0,4 0,4 0,4 0,4 0,4 0,4 0,4 0,4 6,2 6,2 6,2 0,4 0,4 0,4
0,4 0,4 0,4 0,4 6,2 6,2 0,4 0,4 6,2 6,2 0,4 0,4 0,4 0,4 0,4 0,4 0,4 0,4 0,4 0,4 0,4 6,2 6,2 6,2 0,4
0,4 0,4 0,4 6,2 6,2 0,4 0,4 0,4 0,4 6,2 6,2 0,4 0,4 0,4 0,4 0,4 0,4 0,4 0,4 0,4 6,2 6,2 0,4 6,2 6,2
0,4 6,2 6,2 0,4 0,4 0,4 0,4 0,4 0,4 0,4 6,2 6,2 6,2 6,2 6,2 6,2 6,2 6,2 0,4 6,2 6,2 0,4 0,4 0,4 6,2
6,2 6,2 0,4 0,4 0,4 0,4 0,4 0,4 0,4 0,4 6,2 0,4 0,4 0,4 0,4 0,4 0,4 6,2 6,2 6,2 6,2 6,2 0,4 0,4 0,4
0,4 0,4 0,4 0,4 0,4 0,4 0,4 0,4 0,4 6,2 6,2 6,2 0,4 0,4 0,4 0,4 0,4 0,4 0,4 0,4 0,4 6,2 6,2 0,4 0,4
0,4 0,4 0,4 0,4 0,4 0,4 6,2 6,2 6,2 6,2 6,2 6,2 6,2 6,2 6,2 6,2 6,2 0,4 0,4 0,4 0,4 0,4 6,2 6,2 0,4
0,4 0,4 0,4 0,4 6,2 6,2 6,2 0,4 0,4 0,4 6,2 6,2 0,4 0,4 0,4 0,4 6,2 6,2 6,2 0,4 0,4 0,4 0,4 6,2 6,2
z,1
s16
12s
d12
0,d
1,1 1,1 1,1 1,1 1,1 1,1 1,1 6,2 1,1 1,1 1,1 1,1 6,2 1,1 1,1 1,1 1,1 1,1 1,1 6,2 1,1 1,1 1,1 1,1 1,1
6,2 6,2 1,1 1,1 1,1 1,1 1,1 6,2 6,2 6,2 1,1 1,1 6,2 6,2 1,1 1,1 6,2 6,2 6,2 6,2 1,1 1,1 1,1 1,1 1,1
1,1 6,2 6,2 1,1 1,1 1,1 1,1 1,1 1,1 6,2 6,2 6,2 6,2 6,2 6,2 6,2 6,2 1,1 1,1 1,1 1,1 1,1 6,2 6,2 1,1
1,1 1,1 6,2 6,2 1,1 1,1 1,1 1,1 1,1 1,1 1,1 1,1 1,1 6,2 1,1 1,1 1,1 1,1 1,1 1,1 1,1 6,2 6,2 6,2 6,2
1,1 1,1 1,1 6,2 6,2 6,2 1,1 1,1 1,1 1,1 1,1 1,1 6,2 6,2 1,1 1,1 1,1 1,1 1,1 6,2 6,2 6,2 1,1 1,1 1,1
1,1 1,1 1,1 1,1 1,1 6,2 6,2 6,2 1,1 1,1 1,1 1,1 6,2 1,1 1,1 1,1 1,1 1,1 6,2 6,2 1,1 1,1 1,1 1,1 1,1
1,1 1,1 1,1 1,1 1,1 1,1 1,1 6,2 6,2 1,1 1,1 1,1 6,2 1,1 1,1 1,1 1,1 6,2 6,2 6,2 6,2 6,2 6,2 6,2 6,2
1,1 1,1 1,1 1,1 1,1 1,1 1,1 1,1 6,2 6,2 6,2 1,1 6,2 1,1 1,1 1,1 6,2 6,2 1,1 1,1 1,1 1,1 1,1 1,1 6,2
1,1 1,1 1,1 1,1 1,1 1,1 1,1 1,1 1,1 1,1 6,2 6,2 6,2 1,1 6,2 6,2 6,2 1,1 1,1 1,1 1,1 1,1 1,1 1,1 1,1
1,1 1,1 1,1 1,1 1,1 1,1 1,1 1,1 1,1 1,1 1,1 6,2 6,2 6,2 6,2 1,1 1,1 1,1 1,1 1,1 1,1 1,1 1,1 1,1 1,1
6,2 6,2 6,2 6,2 6,2 6,2 6,2 6,2 6,2 1,1 1,1 1,1 6,2 6,2 1,1 1,1 1,1 1,1 1,1 1,1 1,1 6,2 6,2 6,2 6,2
1,1 1,1 1,1 1,1 1,1 1,1 1,1 1,1 6,2 6,2 6,2 6,2 6,2 6,2 6,2 6,2 6,2 6,2 6,2 6,2 6,2 6,2 1,1 1,1 1,1
1,1 1,1 1,1 1,1 1,1 1,1 1,1 1,1 1,1 1,1 1,1 1,1 1,1 6,2 6,2 6,2 6,2 1,1 1,1 1,1 1,1 1,1 1,1 1,1 1,1
1,1 1,1 1,1 1,1 1,1 1,1 6,2 6,2 6,2 6,2 6,2 6,2 6,2 6,2 1,1 1,1 6,2 6,2 6,2 6,2 1,1 1,1 1,1 1,1 1,1
6,2 6,2 6,2 6,2 6,2 6,2 6,2 1,1 1,1 1,1 1,1 1,1 1,1 1,1 1,1 1,1 1,1 1,1 1,1 6,2 6,2 6,2 6,2 6,2 6,2
z,1
d16
12d
1,1 1,1 1,1 1,1 1,1 1,1 1,1 1,1 1,1 1,1 2,3 2,3 2,3 1,1 1,1 1,1 1,1 1,1 1,1 1,1 1,1 1,1 2,3 2,3 2,3
1,1 1,1 2,3 2,3 1,1 1,1 1,1 1,1 1,1 1,1 2,3 2,3 2,3 1,1 1,1 1,1 1,1 1,1 1,1 1,1 1,1 2,3 2,3 2,3 2,3
1,1 1,1 2,3 2,3 1,1 1,1 1,1 1,1 1,1 1,1 2,3 2,3 2,3 2,3 1,1 1,1 1,1 1,1 1,1 2,3 2,3 2,3 2,3 2,3 1,1
1,1 1,1 2,3 2,3 1,1 1,1 1,1 1,1 1,1 1,1 1,1 2,3 2,3 2,3 2,3 2,3 1,1 2,3 2,3 2,3 2,3 2,3 1,1 1,1 1,1
1,1 1,1 2,3 2,3 2,3 2,3 2,3 2,3 2,3 2,3 2,3 2,3 2,3 2,3 2,3 2,3 2,3 2,3 2,3 2,3 2,3 2,3 1,1 1,1 1,1
1,1 1,1 2,3 2,3 2,3 2,3 2,3 2,3 2,3 2,3 2,3 2,3 2,3 2,3 2,3 2,3 2,3 2,3 2,3 2,3 2,3 2,3 2,3 2,3 1,1
1,1 1,1 2,3 2,3 2,3 1,1 1,1 1,1 1,1 2,3 2,3 2,3 1,1 1,1 1,1 1,1 2,3 2,3 2,3 2,3 2,3 2,3 2,3 2,3 1,1
1,1 1,1 1,1 2,3 2,3 2,3 1,1 1,1 1,1 1,1 2,3 2,3 1,1 1,1 1,1 1,1 1,1 1,1 2,3 2,3 2,3 2,3 2,3 2,3 1,1
1,1 1,1 1,1 2,3 2,3 2,3 1,1 1,1 1,1 1,1 2,3 2,3 2,3 2,3 1,1 1,1 1,1 1,1 1,1 2,3 2,3 2,3 2,3 2,3 1,1
1,1 1,1 1,1 1,1 2,3 2,3 2,3 1,1 1,1 1,1 1,1 2,3 2,3 2,3 1,1 1,1 1,1 1,1 1,1 2,3 2,3 2,3 2,3 2,3 2,3
1,1 1,1 1,1 1,1 2,3 2,3 2,3 2,3 1,1 1,1 1,1 1,1 2,3 2,3 2,3 1,1 1,1 1,1 1,1 1,1 2,3 2,3 2,3 2,3 2,3
1,1 1,1 1,1 1,1 1,1 2,3 2,3 2,3 2,3 1,1 1,1 1,1 1,1 2,3 2,3 2,3 2,3 2,3 2,3 1,1 1,1 2,3 2,3 2,3 2,3
1,1 1,1 1,1 1,1 1,1 2,3 2,3 2,3 2,3 2,3 1,1 1,1 1,1 1,1 2,3 2,3 2,3 2,3 2,3 1,1 1,1 1,1 2,3 2,3 2,3
1,1 1,1 1,1 1,1 1,1 1,1 2,3 2,3 2,3 2,3 1,1 1,1 1,1 1,1 1,1 2,3 2,3 2,3 2,3 1,1 1,1 1,1 1,1 2,3 2,3
1,1 1,1 1,1 1,1 1,1 1,1 1,1 2,3 2,3 2,3 2,3 1,1 1,1 1,1 1,1 1,1 1,1 1,1 1,1 1,1 1,1 1,1 1,1 1,1 2,3