r,5
t,4
y,2
f,5
g,0
h,2
d11
0,d
3,2 3,2 3,2 3,2 3,2 3,2 3,2 3,2 3,2 3,2 3,2 3,4 3,2 3,2 3,2 3,2 3,4 3,4 3,4 3,4 3,4 3,2 3,2 3,2 3,2
3,2 3,2 3,2 3,2 3,2 3,2 3,2 3,2 3,2 3,2 3,4 3,4 3,2 3,2 3,2 3,2 3,4 3,2 3,2 3,2 3,2 3,2 3,2 3,2 3,4
3,2 3,2 3,2 3,2 3,2 3,2 3,4 3,4 3,4 3,4 3,4 3,4 3,2 3,2 3,2 3,2 3,4 3,2 3,2 3,2 3,2 3,2 3,2 3,4 3,4
3,2 3,2 3,2 3,2 3,4 3,4 3,4 3,2 3,2 3,2 3,2 3,4 3,4 3,2 3,2 3,2 3,4 3,2 3,2 3,2 3,2 3,2 3,4 3,2 3,2
3,2 3,2 3,2 3,4 3,4 3,2 3,2 3,2 3,2 3,2 3,2 3,2 3,4 3,4 3,2 3,2 3,4 3,2 3,2 3,2 3,2 3,4 3,4 3,2 3,2
3,2 3,4 3,4 3,4 3,4 3,2 3,2 3,2 3,2 3,2 3,2 3,2 3,2 3,4 3,4 3,4 3,4 3,4 3,4 3,2 3,4 3,4 3,2 3,2 3,2
3,4 3,4 3,2 3,2 3,4 3,4 3,2 3,2 3,2 3,2 3,2 3,2 3,2 3,2 3,2 3,2 3,2 3,2 3,4 3,4 3,4 3,2 3,2 3,2 3,2
3,2 3,2 3,2 3,2 3,4 3,4 3,4 3,2 3,2 3,2 3,2 3,2 3,2 3,2 3,2 3,2 3,2 3,2 3,2 3,2 3,4 3,2 3,2 3,2 3,2
3,2 3,2 3,2 3,2 3,4 3,2 3,4 3,4 3,2 3,2 3,2 3,2 3,4 3,4 3,4 3,4 3,4 3,4 3,2 3,2 3,4 3,4 3,4 3,4 3,2
3,2 3,2 3,2 3,4 3,4 3,2 3,2 3,4 3,4 3,2 3,4 3,4 3,4 3,2 3,2 3,2 3,2 3,2 3,2 3,2 3,4 3,2 3,2 3,4 3,4
3,2 3,2 3,2 3,4 3,2 3,2 3,2 3,2 3,4 3,4 3,4 3,4 3,4 3,2 3,2 3,2 3,2 3,2 3,2 3,2 3,4 3,4 3,2 3,2 3,2
3,2 3,2 3,4 3,4 3,2 3,2 3,2 3,2 3,4 3,2 3,2 3,2 3,4 3,4 3,4 3,2 3,2 3,2 3,2 3,2 3,2 3,4 3,2 3,2 3,2
3,2 3,2 3,4 3,4 3,2 3,2 3,2 3,2 3,4 3,4 3,2 3,2 3,2 3,2 3,4 3,2 3,2 3,2 3,2 3,2 3,2 3,4 3,4 3,2 3,2
3,2 3,2 3,2 3,4 3,2 3,2 3,2 3,2 3,2 3,4 3,2 3,2 3,2 3,2 3,4 3,4 3,2 3,2 3,2 3,2 3,2 3,2 3,4 3,2 3,2
3,2 3,2 3,2 3,4 3,4 3,2 3,2 3,2 3,2 3,4 3,2 3,2 3,2 3,2 3,2 3,4 3,2 3,2 3,2 3,2 3,2 3,2 3,4 3,4 3,2
z,1
s11
0,s
d,5
14d
3,4 3,2 3,2 3,2 3,2 3,2 3,2 3,2 3,2 3,2 3,2 3,4 3,2 3,2 3,2 3,2 3,2 3,2 3,2 3,4 3,4 3,2 3,2 3,2 3,2
3,4 3,4 3,4 3,2 3,2 3,2 3,2 3,2 3,2 3,2 3,4 3,4 3,2 3,2 3,2 3,2 3,2 3,2 3,4 3,4 3,2 3,2 3,2 3,2 3,2
3,2 3,2 3,4 3,4 3,4 3,2 3,2 3,4 3,4 3,4 3,4 3,2 3,2 3,2 3,2 3,2 3,2 3,4 3,4 3,2 3,2 3,2 3,2 3,2 3,2
3,2 3,2 3,2 3,2 3,4 3,4 3,4 3,4 3,4 3,2 3,2 3,2 3,2 3,2 3,2 3,2 3,4 3,4 3,2 3,2 3,2 3,2 3,2 3,2 3,2
3,4 3,2 3,2 3,2 3,2 3,4 3,4 3,2 3,4 3,4 3,2 3,2 3,2 3,2 3,2 3,4 3,4 3,2 3,2 3,2 3,2 3,2 3,2 3,2 3,2
3,4 3,4 3,4 3,2 3,2 3,4 3,2 3,2 3,2 3,4 3,4 3,2 3,2 3,2 3,4 3,4 3,2 3,2 3,2 3,2 3,2 3,2 3,2 3,2 3,2
3,2 3,2 3,4 3,4 3,4 3,4 3,2 3,2 3,2 3,2 3,4 3,4 3,2 3,4 3,4 3,2 3,2 3,2 3,2 3,2 3,2 3,2 3,2 3,2 3,2
3,2 3,2 3,2 3,4 3,4 3,4 3,2 3,2 3,2 3,2 3,2 3,4 3,4 3,4 3,2 3,2 3,2 3,2 3,2 3,2 3,2 3,2 3,2 3,2 3,2
3,2 3,2 3,4 3,4 3,2 3,4 3,4 3,4 3,2 3,2 3,2 3,4 3,4 3,4 3,4 3,2 3,2 3,2 3,2 3,2 3,2 3,2 3,2 3,2 3,4
3,4 3,4 3,4 3,2 3,2 3,2 3,2 3,4 3,4 3,4 3,4 3,4 3,2 3,2 3,4 3,4 3,2 3,2 3,2 3,2 3,4 3,4 3,4 3,4 3,4
3,4 3,2 3,2 3,2 3,2 3,2 3,2 3,2 3,2 3,4 3,4 3,2 3,2 3,2 3,2 3,4 3,4 3,2 3,2 3,4 3,4 3,2 3,2 3,2 3,2
3,4 3,2 3,2 3,2 3,2 3,2 3,2 3,2 3,4 3,4 3,2 3,2 3,2 3,2 3,2 3,2 3,4 3,4 3,4 3,4 3,2 3,2 3,2 3,2 3,2
3,2 3,2 3,2 3,2 3,2 3,2 3,2 3,2 3,4 3,2 3,2 3,2 3,2 3,2 3,2 3,4 3,4 3,4 3,4 3,2 3,2 3,2 3,2 3,2 3,2
3,2 3,2 3,2 3,2 3,2 3,2 3,2 3,4 3,4 3,2 3,2 3,2 3,2 3,2 3,2 3,4 3,2 3,2 3,4 3,4 3,4 3,2 3,2 3,2 3,2
3,2 3,2 3,2 3,2 3,2 3,4 3,4 3,4 3,4 3,2 3,2 3,2 3,2 3,2 3,4 3,4 3,2 3,2 3,2 3,2 3,4 3,4 3,4 3,4 3,2
z,1
s,5
14s
d,1
11d
3,2 3,2 3,2 3,2 3,2 3,4 3,2 3,2 3,2 3,2 3,2 3,2 3,2 3,2 3,4 3,2 3,2 3,2 3,2 3,2 3,2 3,2 3,4 3,4 3,2
3,2 3,2 3,2 3,2 3,2 3,4 3,2 3,2 3,2 3,2 3,2 3,2 3,2 3,4 3,4 3,2 3,2 3,2 3,2 3,2 3,4 3,4 3,4 3,2 3,2
3,2 3,2 3,2 3,2 3,2 3,4 3,2 3,2 3,2 3,2 3,2 3,2 3,2 3,4 3,2 3,2 3,2 3,2 3,2 3,2 3,4 3,2 3,2 3,2 3,2
3,2 3,2 3,2 3,2 3,2 3,4 3,2 3,2 3,2 3,2 3,2 3,2 3,2 3,4 3,2 3,2 3,2 3,2 3,4 3,4 3,4 3,2 3,2 3,2 3,2
3,2 3,2 3,2 3,4 3,4 3,4 3,4 3,4 3,4 3,4 3,4 3,4 3,4 3,4 3,4 3,4 3,4 3,4 3,4 3,2 3,2 3,2 3,2 3,2 3,2
3,4 3,4 3,4 3,4 3,4 3,4 3,4 3,2 3,2 3,2 3,2 3,2 3,2 3,4 3,4 3,2 3,2 3,2 3,2 3,2 3,2 3,2 3,2 3,2 3,2
3,4 3,2 3,2 3,4 3,4 3,2 3,4 3,4 3,2 3,2 3,2 3,2 3,4 3,4 3,4 3,2 3,2 3,2 3,2 3,2 3,2 3,2 3,2 3,2 3,2
3,2 3,2 3,2 3,4 3,2 3,2 3,2 3,4 3,4 3,2 3,2 3,4 3,4 3,2 3,4 3,4 3,2 3,2 3,2 3,2 3,2 3,2 3,2 3,2 3,2
3,2 3,2 3,4 3,4 3,2 3,2 3,2 3,2 3,4 3,4 3,4 3,4 3,2 3,2 3,2 3,4 3,4 3,2 3,2 3,2 3,2 3,2 3,2 3,4 3,4
3,2 3,2 3,4 3,2 3,2 3,2 3,2 3,2 3,4 3,4 3,2 3,2 3,2 3,2 3,2 3,2 3,4 3,2 3,2 3,2 3,2 3,4 3,4 3,4 3,2
3,2 3,4 3,4 3,2 3,2 3,2 3,2 3,2 3,2 3,4 3,4 3,2 3,2 3,2 3,2 3,2 3,4 3,4 3,2 3,4 3,4 3,4 3,2 3,2 3,2
3,2 3,4 3,2 3,2 3,2 3,2 3,2 3,2 3,4 3,4 3,4 3,4 3,2 3,2 3,2 3,2 3,2 3,4 3,4 3,4 3,2 3,2 3,2 3,2 3,2
3,2 3,2 3,2 3,2 3,2 3,2 3,2 3,2 3,4 3,2 3,2 3,4 3,4 3,2 3,2 3,2 3,2 3,2 3,2 3,4 3,4 3,2 3,2 3,2 3,2
3,2 3,2 3,2 3,2 3,2 3,2 3,2 3,4 3,4 3,2 3,2 3,2 3,4 3,4 3,2 3,2 3,2 3,2 3,2 3,2 3,4 3,4 3,2 3,2 3,2
3,2 3,2 3,2 3,2 3,2 3,4 3,4 3,4 3,2 3,2 3,2 3,2 3,2 3,4 3,4 3,2 3,2 3,2 3,2 3,2 3,2 3,4 3,4 3,4 3,2
z,1
s,1
11s
d,1
14d
3,2 3,2 3,2 3,2 3,2 3,4 3,4 3,2 3,2 3,4 3,2 3,2 3,2 3,2 3,2 3,2 3,2 3,2 3,2 3,2 3,4 3,4 3,4 3,2 3,2
3,2 3,2 3,2 3,2 3,4 3,4 3,2 3,2 3,2 3,4 3,2 3,2 3,2 3,2 3,2 3,2 3,2 3,4 3,4 3,4 3,4 3,2 3,2 3,2 3,2
3,2 3,2 3,2 3,4 3,4 3,2 3,2 3,2 3,2 3,4 3,4 3,4 3,2 3,2 3,4 3,4 3,4 3,4 3,2 3,2 3,2 3,2 3,2 3,2 3,4
3,2 3,2 3,4 3,4 3,4 3,4 3,4 3,2 3,2 3,2 3,2 3,4 3,4 3,4 3,4 3,2 3,2 3,2 3,2 3,2 3,2 3,2 3,2 3,2 3,4
3,2 3,4 3,4 3,2 3,2 3,2 3,4 3,4 3,4 3,4 3,4 3,4 3,4 3,4 3,4 3,4 3,4 3,4 3,2 3,2 3,2 3,2 3,4 3,4 3,4
3,2 3,4 3,2 3,2 3,2 3,2 3,2 3,2 3,4 3,4 3,4 3,4 3,2 3,2 3,2 3,2 3,2 3,4 3,4 3,4 3,4 3,4 3,4 3,2 3,2
3,2 3,4 3,2 3,2 3,2 3,2 3,2 3,2 3,2 3,2 3,2 3,4 3,4 3,4 3,2 3,2 3,2 3,2 3,2 3,4 3,4 3,4 3,4 3,4 3,4
3,2 3,4 3,2 3,2 3,2 3,2 3,2 3,2 3,2 3,2 3,2 3,4 3,4 3,4 3,4 3,2 3,2 3,2 3,2 3,2 3,2 3,2 3,2 3,2 3,2
3,2 3,4 3,2 3,2 3,2 3,2 3,2 3,2 3,2 3,4 3,4 3,4 3,2 3,2 3,4 3,4 3,2 3,2 3,2 3,2 3,2 3,2 3,2 3,2 3,2
3,2 3,4 3,2 3,2 3,2 3,2 3,2 3,4 3,4 3,4 3,2 3,2 3,2 3,2 3,2 3,4 3,4 3,2 3,4 3,4 3,4 3,4 3,4 3,4 3,4
3,2 3,4 3,2 3,2 3,2 3,2 3,2 3,2 3,2 3,2 3,2 3,2 3,2 3,2 3,2 3,4 3,4 3,4 3,4 3,2 3,2 3,2 3,2 3,2 3,2
3,2 3,4 3,2 3,2 3,2 3,2 3,2 3,2 3,2 3,2 3,2 3,2 3,2 3,2 3,4 3,4 3,2 3,4 3,4 3,4 3,2 3,2 3,2 3,2 3,2
3,2 3,2 3,2 3,2 3,2 3,2 3,2 3,2 3,2 3,2 3,2 3,2 3,2 3,4 3,4 3,2 3,2 3,2 3,2 3,4 3,4 3,4 3,2 3,2 3,2
3,2 3,2 3,2 3,2 3,2 3,2 3,2 3,2 3,2 3,2 3,2 3,2 3,4 3,4 3,2 3,2 3,2 3,2 3,2 3,2 3,2 3,4 3,4 3,4 3,4
3,2 3,4 3,4 3,4 3,4 3,4 3,4 3,4 3,4 3,4 3,4 3,4 3,4 3,2 3,2 3,2 3,2 3,2 3,2 3,2 3,2 3,2 3,2 3,2 3,2
z,1
s,1
14s
3,2 3,2 3,4 3,2 3,2 3,2 3,2 3,2 3,2 3,2 3,2 3,2 3,2 3,2 3,2 3,2 3,2 3,2 3,2 3,2 3,2 3,4 3,4 3,4 3,2
3,2 3,2 3,4 3,2 3,2 3,2 3,4 3,4 3,4 3,4 3,4 3,4 3,4 3,4 3,4 3,4 3,2 3,2 3,2 3,2 3,4 3,4 3,2 3,2 3,2
3,2 3,2 3,4 3,4 3,4 3,4 3,4 3,2 3,2 3,2 3,2 3,2 3,2 3,2 3,2 3,4 3,4 3,2 3,4 3,4 3,4 3,2 3,2 3,2 3,2
3,2 3,2 3,2 3,4 3,4 3,2 3,2 3,2 3,2 3,2 3,2 3,2 3,2 3,2 3,2 3,2 3,4 3,4 3,4 3,2 3,2 3,2 3,2 3,2 3,2
3,2 3,2 3,2 3,4 3,2 3,2 3,2 3,2 3,2 3,2 3,2 3,2 3,2 3,2 3,2 3,4 3,4 3,2 3,2 3,2 3,2 3,2 3,2 3,2 3,2
3,2 3,2 3,2 3,4 3,4 3,2 3,2 3,2 3,2 3,2 3,2 3,2 3,2 3,2 3,4 3,4 3,4 3,4 3,2 3,2 3,2 3,2 3,2 3,2 3,2
3,2 3,2 3,2 3,2 3,4 3,4 3,2 3,2 3,2 3,2 3,2 3,2 3,4 3,4 3,4 3,2 3,2 3,4 3,4 3,4 3,4 3,2 3,2 3,2 3,2
3,2 3,2 3,2 3,2 3,2 3,4 3,4 3,4 3,2 3,2 3,2 3,4 3,4 3,2 3,2 3,2 3,2 3,2 3,2 3,2 3,4 3,4 3,2 3,2 3,2
3,2 3,2 3,2 3,2 3,2 3,2 3,2 3,4 3,4 3,4 3,4 3,4 3,4 3,4 3,2 3,2 3,2 3,2 3,2 3,2 3,2 3,4 3,4 3,2 3,2
3,2 3,4 3,4 3,4 3,4 3,4 3,4 3,4 3,4 3,4 3,4 3,4 3,2 3,4 3,4 3,2 3,2 3,2 3,2 3,2 3,2 3,2 3,4 3,4 3,4
3,4 3,4 3,2 3,2 3,2 3,2 3,2 3,2 3,4 3,4 3,4 3,2 3,2 3,2 3,4 3,4 3,2 3,2 3,2 3,2 3,2 3,2 3,4 3,4 3,4
3,2 3,2 3,2 3,2 3,2 3,2 3,4 3,4 3,2 3,2 3,4 3,2 3,2 3,2 3,2 3,4 3,4 3,2 3,2 3,2 3,4 3,4 3,4 3,2 3,2
3,2 3,2 3,2 3,2 3,2 3,4 3,4 3,2 3,2 3,2 3,4 3,4 3,2 3,2 3,2 3,2 3,4 3,4 3,2 3,2 3,4 3,2 3,2 3,2 3,2
3,2 3,2 3,2 3,2 3,4 3,4 3,2 3,2 3,2 3,2 3,2 3,4 3,4 3,2 3,2 3,2 3,2 3,4 3,4 3,4 3,4 3,2 3,2 3,2 3,2
3,2 3,4 3,4 3,4 3,4 3,2 3,2 3,2 3,2 3,2 3,2 3,2 3,4 3,2 3,2 3,2 3,2 3,2 3,4 3,2 3,2 3,2 3,2 3,2 3,2