r,3
t,1
y,0
f10
g10
h,3
d21
9,d
6,2 6,2 6,2 6,2 6,2 6,2 6,2 6,2 6,2 6,2 6,2 6,2 6,2 6,2 6,2 6,2 6,2 6,2 6,2 6,2 6,2 6,2 6,2 6,2 6,2
6,2 6,2 6,2 6,2 6,2 6,2 6,2 6,2 6,2 6,2 6,2 6,2 6,2 6,2 6,2 6,2 6,2 6,2 6,2 6,2 6,2 6,2 6,2 6,2 6,2
6,2 6,2 6,2 6,2 6,2 6,2 6,2 6,2 6,2 6,2 6,2 6,2 6,2 6,2 6,2 6,2 6,2 6,2 6,2 6,2 6,2 6,2 6,2 6,2 6,2
6,2 6,2 6,2 6,2 6,2 6,2 6,2 6,2 6,2 6,2 6,2 6,2 6,2 6,2 6,2 6,2 6,2 6,2 6,2 6,2 6,2 6,2 6,2 6,2 6,2
6,2 6,2 6,2 6,2 6,2 6,2 6,2 6,2 6,2 6,2 6,2 6,2 6,2 6,2 6,2 6,2 6,2 6,2 6,2 6,2 6,2 6,2 6,2 6,2 6,2
1,4 1,4 1,4 1,4 1,4 1,4 1,4 1,4 6,2 6,2 6,2 6,2 6,2 6,2 6,2 6,2 6,2 1,4 1,4 1,4 1,4 1,4 1,4 1,4 1,4
1,3 1,3 1,3 1,3 1,3 1,3 1,3 1,4 1,4 1,4 1,3 1,3 1,3 1,3 1,3 1,4 1,4 1,4 1,3 1,3 1,3 1,3 1,3 1,3 1,3
1,3 1,3 1,3 1,3 1,3 1,3 1,3 1,3 1,3 1,3 1,3 1,3 1,3 1,3 1,3 1,3 1,3 1,3 1,3 1,3 1,3 1,3 1,3 1,3 1,3
1,3 1,3 1,3 1,3 1,3 1,3 1,3 1,3 1,3 1,3 1,3 1,3 1,3 1,3 1,3 1,3 1,3 1,3 1,3 1,3 1,4 1,4 1,4 1,3 1,3
1,3 1,3 1,3 1,3 1,3 1,3 1,3 1,3 1,3 1,3 1,3 1,3 1,3 1,3 1,3 1,3 1,3 1,3 1,3 1,3 1,3 1,3 1,4 1,3 1,3
1,3 1,3 1,3 1,3 1,3 1,3 1,3 1,3 1,3 1,3 1,3 0,5 0,5 0,5 0,5 1,3 1,3 1,3 1,3 1,3 1,4 1,4 1,4 1,3 1,3
1,3 1,3 1,3 1,3 1,3 1,3 1,3 1,3 1,3 1,3 1,3 0,5 0,5 0,5 0,5 1,3 1,3 1,3 1,3 1,3 1,3 1,3 1,3 1,3 1,3
3,2 3,2 3,2 3,2 3,2 3,2 3,2 3,2 3,2 3,2 3,2 0,5 0,5 0,5 0,5 3,2 3,2 3,2 3,2 3,2 3,2 3,2 3,2 3,2 3,2
3,2 3,2 3,2 3,2 3,2 3,2 3,2 3,2 3,2 3,2 3,2 0,5 0,5 0,5 0,5 3,2 3,2 3,2 3,2 3,2 3,2 3,2 3,2 3,2 3,2
3,2 3,2 3,2 3,2 3,2 3,2 3,2 3,2 3,2 3,2 3,2 3,2 3,2 3,2 3,2 3,2 3,2 3,2 3,2 3,2 3,2 3,2 3,2 3,2 3,2
z,1
s21
9,s
d23
1,d
5,0 5,0 5,0 5,0 5,0 5,0 5,0 5,0 5,0 5,0 5,0 5,0 5,0 5,0 0,1 5,0 5,0 5,0 5,0 5,0 5,0 5,0 5,0 5,0 5,0
5,0 5,0 5,0 5,0 5,0 5,0 0,1 0,1 5,0 5,0 5,0 5,0 0,1 0,1 0,1 5,0 5,0 5,0 5,0 5,0 5,0 0,1 0,1 0,1 5,0
5,0 5,0 5,0 5,0 5,0 0,1 0,1 0,1 0,1 5,0 5,0 0,1 0,1 5,0 5,0 5,0 5,0 5,0 5,0 5,0 5,0 0,1 5,0 5,0 5,0
0,1 0,1 0,1 5,0 0,1 0,1 5,0 5,0 0,1 0,1 5,0 0,1 5,0 5,0 5,0 5,0 5,0 5,0 0,1 0,1 0,1 0,1 5,0 5,0 5,0
5,0 5,0 0,1 0,1 0,1 5,0 5,0 5,0 5,0 0,1 0,1 0,1 5,0 5,0 5,0 5,0 5,0 5,0 0,1 5,0 5,0 5,0 5,0 5,0 5,0
5,0 5,0 5,0 0,1 5,0 5,0 5,0 5,0 5,0 0,1 0,1 0,1 0,1 0,1 0,1 0,1 0,1 0,1 0,1 5,0 5,0 5,0 5,0 5,0 5,0
5,0 5,0 5,0 0,1 5,0 5,0 5,0 5,0 5,0 0,1 5,0 5,0 5,0 5,0 5,0 5,0 5,0 5,0 0,1 0,1 5,0 5,0 5,0 5,0 5,0
5,0 5,0 5,0 0,1 5,0 5,0 5,0 5,0 5,0 0,1 5,0 5,0 5,0 5,0 5,0 5,0 5,0 5,0 5,0 0,1 5,0 5,0 5,0 5,0 5,0
5,0 5,0 5,0 0,1 5,0 5,0 5,0 5,0 5,0 0,1 5,0 5,0 5,0 5,0 5,0 5,0 5,0 5,0 5,0 0,1 0,1 0,1 5,0 5,0 5,0
5,0 5,0 0,1 0,1 0,1 0,1 0,1 0,1 0,1 0,1 0,1 0,1 0,1 0,1 0,1 0,1 0,1 0,1 0,1 0,1 0,1 0,1 5,0 5,0 5,0
5,0 5,0 5,0 0,1 5,0 5,0 0,1 0,1 5,0 5,0 5,0 5,0 0,1 0,1 5,0 5,0 5,0 5,0 5,0 5,0 5,0 0,1 5,0 5,0 5,0
5,0 5,0 0,1 0,1 5,0 5,0 5,0 0,1 5,0 5,0 5,0 5,0 5,0 0,1 5,0 5,0 5,0 5,0 5,0 5,0 5,0 0,1 5,0 5,0 5,0
5,0 0,1 0,1 5,0 5,0 5,0 5,0 0,1 5,0 5,0 5,0 5,0 5,0 0,1 0,1 5,0 5,0 5,0 5,0 5,0 5,0 0,1 5,0 5,0 5,0
0,1 0,1 5,0 5,0 5,0 5,0 5,0 0,1 5,0 5,0 5,0 5,0 5,0 5,0 0,1 0,1 5,0 5,0 5,0 5,0 0,1 0,1 5,0 5,0 5,0
0,1 5,0 5,0 5,0 5,0 5,0 5,0 0,1 5,0 5,0 5,0 5,0 5,0 5,0 5,0 0,1 0,1 0,1 0,1 0,1 0,1 5,0 5,0 5,0 5,0
z,1
s23
1,s
d24
14d
0,1 6,0 6,0 6,0 6,0 6,0 6,0 6,0 6,0 6,0 6,0 6,0 6,0 6,0 6,0 6,0 6,0 6,0 6,0 6,0 6,0 6,0 6,0 6,0 6,0
0,1 0,1 0,1 6,0 6,0 6,0 6,0 6,0 6,0 6,0 6,0 6,0 6,0 6,0 6,0 6,0 6,0 6,0 6,0 6,0 0,1 0,1 0,1 0,1 6,0
6,0 6,0 0,1 0,1 6,0 6,0 6,0 6,0 6,0 6,0 6,0 6,0 6,0 6,0 6,0 6,0 6,0 0,1 0,1 0,1 0,1 6,0 6,0 6,0 6,0
6,0 6,0 6,0 0,1 0,1 6,0 6,0 6,0 6,0 6,0 6,0 6,0 6,0 6,0 6,0 0,1 0,1 0,1 6,0 6,0 6,0 6,0 6,0 6,0 6,0
6,0 6,0 6,0 6,0 0,1 0,1 6,0 6,0 6,0 6,0 6,0 6,0 0,1 0,1 0,1 0,1 6,0 6,0 6,0 6,0 6,0 6,0 6,0 6,0 6,0
6,0 6,0 6,0 6,0 6,0 0,1 0,1 6,0 6,0 6,0 6,0 0,1 0,1 6,0 6,0 0,1 0,1 6,0 6,0 6,0 6,0 6,0 6,0 6,0 6,0
6,0 6,0 6,0 6,0 6,0 6,0 0,1 6,0 6,0 0,1 0,1 0,1 6,0 6,0 6,0 6,0 0,1 0,1 6,0 6,0 6,0 6,0 6,0 6,0 6,0
6,0 6,0 6,0 6,0 6,0 6,0 0,1 0,1 0,1 0,1 6,0 6,0 6,0 6,0 6,0 6,0 6,0 0,1 0,1 6,0 6,0 6,0 6,0 6,0 6,0
6,0 6,0 6,0 6,0 6,0 0,1 0,1 0,1 6,0 0,1 0,1 6,0 6,0 6,0 6,0 6,0 6,0 6,0 0,1 6,0 6,0 6,0 6,0 6,0 6,0
6,0 6,0 6,0 0,1 0,1 0,1 6,0 6,0 6,0 6,0 0,1 6,0 6,0 6,0 6,0 6,0 6,0 6,0 0,1 0,1 0,1 0,1 0,1 0,1 0,1
6,0 6,0 0,1 0,1 6,0 6,0 6,0 6,0 6,0 6,0 0,1 0,1 6,0 6,0 6,0 6,0 6,0 0,1 0,1 0,1 6,0 6,0 6,0 6,0 6,0
6,0 6,0 0,1 6,0 6,0 6,0 6,0 6,0 6,0 6,0 6,0 0,1 0,1 0,1 0,1 0,1 0,1 0,1 6,0 6,0 6,0 6,0 6,0 6,0 6,0
6,0 6,0 0,1 0,1 0,1 0,1 0,1 6,0 6,0 6,0 6,0 6,0 0,1 0,1 6,0 6,0 6,0 6,0 6,0 6,0 6,0 6,0 6,0 6,0 6,0
6,0 0,1 0,1 6,0 6,0 6,0 0,1 0,1 0,1 0,1 0,1 0,1 0,1 0,1 0,1 0,1 0,1 0,1 0,1 6,0 6,0 6,0 6,0 6,0 6,0
0,1 0,1 6,0 6,0 6,0 6,0 6,0 6,0 6,0 6,0 6,0 6,0 6,0 6,0 6,0 6,0 6,0 6,0 0,1 0,1 0,1 0,1 0,1 0,1 0,1
z,1
s24
14s
d,8
2,d
6,0 6,0 6,0 6,0 6,0 6,0 6,0 6,0 6,0 6,0 6,0 6,0 6,0 6,0 6,0 6,0 6,0 6,0 6,0 6,0 6,0 6,0 6,0 0,1 0,1
0,1 6,0 6,0 6,0 6,0 6,0 6,0 6,0 6,0 6,0 6,0 6,0 6,0 6,0 6,0 6,0 6,0 6,0 6,0 6,0 0,1 0,1 0,1 0,1 6,0
0,1 0,1 6,0 6,0 6,0 6,0 6,0 6,0 0,1 6,0 6,0 6,0 6,0 6,0 6,0 6,0 6,0 6,0 6,0 0,1 0,1 6,0 6,0 6,0 6,0
6,0 0,1 0,1 6,0 6,0 6,0 6,0 0,1 0,1 0,1 0,1 6,0 6,0 0,1 0,1 0,1 0,1 0,1 0,1 0,1 6,0 6,0 6,0 6,0 6,0
6,0 6,0 0,1 0,1 0,1 6,0 6,0 0,1 6,0 6,0 0,1 0,1 0,1 0,1 6,0 6,0 6,0 6,0 6,0 6,0 6,0 6,0 6,0 6,0 6,0
6,0 6,0 6,0 6,0 0,1 0,1 0,1 0,1 6,0 6,0 6,0 0,1 0,1 0,1 6,0 6,0 6,0 6,0 6,0 6,0 6,0 6,0 6,0 6,0 6,0
6,0 6,0 6,0 6,0 6,0 6,0 0,1 6,0 6,0 6,0 6,0 6,0 0,1 0,1 0,1 0,1 0,1 6,0 6,0 6,0 6,0 6,0 6,0 6,0 6,0
6,0 6,0 6,0 6,0 6,0 6,0 0,1 6,0 6,0 6,0 6,0 6,0 0,1 0,1 6,0 6,0 0,1 0,1 0,1 0,1 6,0 6,0 6,0 6,0 6,0
6,0 6,0 6,0 6,0 6,0 0,1 0,1 6,0 6,0 6,0 6,0 6,0 6,0 0,1 0,1 6,0 6,0 6,0 6,0 0,1 0,1 0,1 6,0 6,0 6,0
6,0 6,0 6,0 6,0 6,0 0,1 6,0 6,0 6,0 6,0 6,0 6,0 6,0 6,0 0,1 0,1 6,0 6,0 6,0 6,0 6,0 0,1 0,1 0,1 0,1
6,0 6,0 6,0 6,0 0,1 0,1 6,0 0,1 0,1 0,1 0,1 6,0 6,0 6,0 6,0 0,1 6,0 6,0 6,0 6,0 6,0 6,0 6,0 6,0 6,0
6,0 6,0 6,0 0,1 0,1 0,1 0,1 0,1 6,0 6,0 6,0 6,0 6,0 6,0 6,0 0,1 0,1 6,0 6,0 6,0 6,0 6,0 6,0 6,0 6,0
6,0 6,0 6,0 0,1 6,0 6,0 6,0 0,1 0,1 6,0 6,0 6,0 6,0 6,0 6,0 6,0 0,1 0,1 6,0 6,0 6,0 6,0 6,0 6,0 6,0
6,0 0,1 0,1 0,1 6,0 6,0 6,0 6,0 0,1 0,1 6,0 6,0 6,0 6,0 6,0 6,0 6,0 0,1 0,1 6,0 6,0 6,0 6,0 6,0 6,0
0,1 0,1 6,0 0,1 0,1 0,1 0,1 0,1 0,1 0,1 6,0 6,0 6,0 6,0 6,0 6,0 6,0 6,0 0,1 0,1 0,1 0,1 0,1 0,1 0,1
z,1
s,8
2,s
0,1 0,1 0,1 0,1 6,0 6,0 6,0 6,0 6,0 6,0 6,0 6,0 6,0 6,0 6,0 6,0 6,0 6,0 6,0 6,0 6,0 6,0 6,0 6,0 6,0
6,0 6,0 6,0 0,1 0,1 0,1 6,0 6,0 0,1 0,1 0,1 0,1 0,1 0,1 0,1 6,0 6,0 6,0 6,0 6,0 6,0 6,0 6,0 6,0 6,0
6,0 6,0 6,0 6,0 6,0 0,1 0,1 0,1 0,1 6,0 6,0 6,0 6,0 6,0 0,1 0,1 0,1 0,1 0,1 0,1 0,1 0,1 0,1 0,1 0,1
6,0 6,0 6,0 6,0 6,0 0,1 0,1 0,1 0,1 6,0 6,0 6,0 6,0 6,0 6,0 6,0 6,0 6,0 6,0 6,0 6,0 6,0 6,0 6,0 6,0
6,0 6,0 0,1 0,1 0,1 0,1 6,0 6,0 0,1 0,1 0,1 6,0 6,0 6,0 6,0 6,0 6,0 6,0 6,0 6,0 6,0 6,0 6,0 6,0 6,0
0,1 0,1 0,1 6,0 6,0 6,0 6,0 6,0 0,1 6,0 0,1 0,1 0,1 0,1 6,0 6,0 6,0 6,0 6,0 6,0 6,0 6,0 6,0 6,0 6,0
6,0 6,0 6,0 6,0 6,0 6,0 0,1 0,1 0,1 6,0 6,0 6,0 6,0 0,1 0,1 0,1 6,0 6,0 6,0 6,0 6,0 6,0 6,0 6,0 0,1
6,0 6,0 6,0 6,0 0,1 0,1 0,1 6,0 0,1 0,1 6,0 6,0 6,0 6,0 6,0 0,1 0,1 6,0 6,0 6,0 6,0 6,0 0,1 0,1 0,1
6,0 6,0 6,0 0,1 0,1 6,0 6,0 6,0 6,0 0,1 6,0 6,0 6,0 6,0 6,0 6,0 0,1 0,1 6,0 6,0 0,1 0,1 0,1 6,0 6,0
6,0 6,0 0,1 0,1 6,0 6,0 6,0 6,0 6,0 0,1 6,0 6,0 6,0 6,0 6,0 6,0 6,0 0,1 0,1 0,1 0,1 6,0 6,0 6,0 6,0
6,0 6,0 0,1 6,0 6,0 6,0 6,0 6,0 0,1 0,1 6,0 6,0 6,0 6,0 6,0 6,0 6,0 6,0 0,1 6,0 6,0 6,0 6,0 6,0 6,0
6,0 0,1 0,1 6,0 6,0 6,0 6,0 6,0 0,1 6,0 6,0 6,0 6,0 6,0 6,0 6,0 6,0 0,1 0,1 0,1 0,1 6,0 6,0 6,0 6,0
0,1 0,1 6,0 6,0 6,0 6,0 6,0 6,0 0,1 6,0 6,0 6,0 6,0 6,0 6,0 6,0 0,1 0,1 6,0 6,0 0,1 0,1 6,0 6,0 6,0
0,1 6,0 6,0 6,0 6,0 6,0 6,0 6,0 0,1 0,1 6,0 6,0 6,0 6,0 6,0 0,1 0,1 6,0 6,0 6,0 6,0 0,1 0,1 6,0 6,0
6,0 6,0 6,0 6,0 6,0 6,0 6,0 6,0 6,0 0,1 6,0 6,0 6,0 6,0 0,1 0,1 6,0 6,0 6,0 6,0 6,0 6,0 0,1 0,1 0,1